#############
#S..........#
#.#.###.#..##
#..#.#.#...##
#####.#.#.###
#..#.#.#....#
###.#.###.#.#
#.#.#...#...#
#.#.#####.#.#
#..#.#.######
#......E....#
#############