...........
...#E......
...#####...
...........
.......S...
...........